XXXXXXXXXXXXXXXXXXXXXXXXXXXXX
XX           XXXXX          X
XX XXXXX XXX XXXXX XXXXXXXX X
XX XXX   XXX          X     X
XXXXXXXX XXX XXXXXXXX XX XXXX
XX             X         XXXX
XXXX XXXXXXXXXXXXXX XXXXXXXXX
XX   XXXX   XX   XX         X
XX XXXXXX X XXXX XXXXXXXXXX X
X         X       X         X
XX XX XXX XXXX XXXX XXXXX XXX
XX XX     XXXX      XX     XX
XXXXXXXXXXXXXXXXXXXXXXXXXXXXX
