XXXXXXXXXXXXXXXXXXXXXXXXXXXXX
XX     M     XXXXX    M     X
XX XXXXX XXX XXXXX XXXXXXXX X
XX XXX   XXX    M     X     X
XXXXXXXX XXX XXXXXXXX XXMXXXX
XX             X    M    XXXX
XXXX XXXMXXXXXXXXXX MXXXXXXXX
XXM  XXXX   XX   XX   M     X
XXXXXXXXX X XXXX XXXXXXXXXX X
X    M    X   M   X    M    X
XX XX XXX XXXX XXXXMXXXXX XXX
XX XX  M  XXXX   M XXX  M  XX
X  M XXXXXXXXXXXXXXXXXXX M  X
X   M   M       M      MX   X
X XXXXXXXXXXXXXXXXXXXXX XXX X
X X    M             M    X X
X X XXXXXXXXXXXXXXXXXXXMXX  X
X X        M           X M  X
X XXXXXXXXXXXXXX M X   X M  X
X X   X  M     X   X M X    X
X X X X XXXXXX X M X   X    X
X X X X X    X X   X   X    X
X X X X X X  X X  X M X     X
X X X X X X  X X  XXXXXXXXX X
X X X X X X FX XXM    M     X
X X X X X XXXX X       M    X
X X X X X  M   X   M        X
X M X    XXXXXXXX           X
XXXXXXXXXXXXXXXXXXXXXXXXXXXXX
