XXXXXXXXXXXXXXXXXXXXXXXXXXXXX
XX     M     XXXXX    M     X
XX XXXXX XXX XXXXX XXXXXXXX X
XX XXX   XXX    M     X     X
XXXXXXXX XXX XXXXXXXX XXMXXXX
XX             X    M    XXXX
XXXX XXXMXXXXXXXXXX MXXXXXXXX
XX   XXXX   XX   XX   M     X
XX XXXXXX X XXXX XXXXXXXXXX X
X    M    X   M   X    M    X
XX XX XXX XXXX XXXXMXXXXX XXX
XX XX  M  XXXX   M  XX  M  XX
X  M XXXXXXXXXXXXXXXXXXX M  X
X   M   M       M       M   X
X XXXXXXXXXXXXXXXXXXXXXXXXX X
X X    M             M    X X
X X XXXXXXXXXXXXXXXXXXXM X  X
X X X      M        X  X M  X
X X X XXXXXXXXXX M X   X M  X
X X X X  M     X   X M X    X
X X X X XXXXXX X M X   X    X
X X X X X    X X   X M X    X
X X X X X X  X X  X M X     X
X X X X X X  X X  XXXXXXXXX X
X X X X X X MX XXM    M     X
X X X X X XXXX X       M    X
X X X X X  M   X   M        X
X M X X XXXXXXXXX    M      X
XXXXXXXXXXXXXXXXXXXXXXXXXXXXX
